11111111
1E000011
100CCCC1
1P001111
11111111
11111111