1111111
1E00001
1000111
1P001C1
1111111