1111111
1E00001
100C111
1P001C1
1111111